WWWWWWWWWWWWWWWWWWWWWWWWWWWWWWWWWWWWWWWWWWWWWWWWWWWWWWWWWWWW
W J WD  W   W   W  DW   W   W   W   W   W   W   W   W   W  W
W        E  B      B   B                    D              W
W   W   W   W   W   W   W   W   W   W   W   W   W   W   W  W
W                   D             K            B           W
W   W   WK  W   W   W  DW   W   W E W   W   W   W   WD  W  W
W         D                            K                   W
W   W   W   W   W D W   W   WD  W   W   W   W   W   W   W  W
W                                                          W
WB  W   W   W   W   W   W   W   W   W   W   WD  W   W B W  W
WD     E                  B          D             E       W
W   W   W   W   W   W   W   W   W   W   W   W   W   W   W  W
W          E     D   D                                   D W
W D W   W   W   W   W   W   W   W   W   W   W   W   W   W  W
W                                         D       D     D  W
W D W   W   W   W   W   W   W   W   W   W   W   W   W   W  W
W                   D                                      W
W   W D W   W   W   W   W   W   W   W   W   W   W   W   W  W
WB    KD                                                   W
W  DW   W   W   W   W   W   WDD W   W   W   W   W   W   W  W
W                                                          W
W   W   W   W   W   WB  W   W   W   W   W   W   W   W   W  W
W                                                     K    W
W   W   W  DW   W   W   W   WD  W   W D W   W   WB  W  DW  W
WWWWWWWWWWWWWWWWWWWWWWWWWWWWWWWWWWWWWWWWWWWWWWWWWWWWWWWWWWWW