WWWWWWWWWWWWWWWWWWWWWWWWWWWWWWWWWWWWWWWWWWWWWWWWWWWWWWWWWWWW
W J              W                                         W
W                         D    W                           W
W                                              D       D   W
W    K W   B                                  D            W
W        D             D                  K                W
W                      D                                   W
W                   E                                      W
W   BE                         D       D                   W
W        K           D                        K     K      W
W                              W                 D         W
W                             D                            W
W          W                                             D W
W      D     D                                             W
W            D        D    E    B         D                W
W         D   W  E                                   B     W
W W                                                        W
W            DD    D              W                        W
W                 B                                        W
W                                       W    B             W
W  B                              D       W           D    W
W  D                                           B        D  W
W          E                           B             D     W
W  B                                   D              D D  W
WWWWWWWWWWWWWWWWWWWWWWWWWWWWWWWWWWWWWWWWWWWWWWWWWWWWWWWWWWWW