WWWWWWWWWWWWWWWWWWWWWWWWWWWWWWWWWWWWWWWWWWWWWWWWWWWWWWWWWWWW
W J             E                E                E        W
W              E             D  E                          W
W  WB          WB          WB          WB                 DW
W  DB          DB          DB          DB                  W
W    W           W        D  W           WD                W
W                                                          W
W                                                          W
W                                                          W
W  WB          WB          WB         DWB                  W
W  DB          DB          DB          DK                  W
W    W          DW           W           W                DW
W                                                          W
W                                D     D                   W
W                                              D           W
W  WB          WB          WB         DWB                  W
W  DK          DK          DK          DK                  W
W    W           W           W           W         DD      W
W                                                          W
W                                                          W
W                                                          W
W       D                  D                               W
W                          D                               W
W                     D                                 D  W
WWWWWWWWWWWWWWWWWWWWWWWWWWWWWWWWWWWWWWWWWWWWWWWWWWWWWWWWWWWW