
WWWWWWWWWWWWWWWWWWWWWWWWWWWWWWWWWWWWWWWWWWWWWWWWWWWWWWWWWWWWWW
WE  D    WW    D  EW    D    WW    D   W    D    WW    D  EW
W DD     WW     DD W DD     WW     DD W DD     WW     DD W
W        WW        W        WW        W        WW        W
W   WWWWWWWWWWWW   W   WWWWWWWWWWWW   W   WWWWWWWWWWWW   W
W   W          W   W   W          W   W   W          W   W
W D W    KB    W D W D W    B     W D W D W    K     W D W
W D W          W D W D W          W D W D W          W D W
W   W          W   W   W          W   W   W          W   W
WJ  WWWWWWWWWWWWW  W   WWWWWWWWWWWWW  W   WWWWWWWWWWWWW  W
W   W          W   W   W          W   W   W          W   W
W D W          W D W D W          W D W D W          W D W
W D W    KB    W D W D W    B     W D W D W    K     W D W
W   W          W   W   W          W   W   W          W   W
W   WWWWWWWWWWWW   W   WWWWWWWWWWWW   W   WWWWWWWWWWWW   W
W        WW        W        WW        W        WW        W
W DD     WW     DD W DD     WW     DD W DD     WW     DD W
W   D    WW    D   W   D    WW    D   W   D    WW    D   W
W                  W                  W                  W
WWWWWWWWWWWWWWWWWWWWWWWWWWWWWWWWWWWWWWWWWWWWWWWWWWWWWWWWWWWWWW
W                                                            W
W DDD DDD DDD DDD DDD DDD DDD DDD DDD DDD DDD DDD DDD DDD DD W
W D D D D D D D D D D D D D D D D D D D D D D D D D D D D D D W
W DDD DDD DDD DDD DDD DDD DDD DDD DDD DDD DDD DDD DDD DDD DD W
WWWWWWWWWWWWWWWWWWWWWWWWWWWWWWWWWWWWWWWWWWWWWWWWWWWWWWWWWWWWWW