WWWWWWWWWWWWWWWWWWWWWWWWWWWWWWWWWWWWWWWWWWWWWWWWWWWWWWWWWWWWWW
WJ   WWWWWWWWWW   EW     WWWWWWWWWW    W     WWWWWWWWWW   EW
W DD W        W DD W     W        W DD W     W        W DD W
W DD W   KB   W DD W     W   B    W DD W     W   K    W DD W
W DD W        W DD W     W        W DD W     W        W DD W
W    WWWWDWWWWW    W     WWWWDWWWWW    W     WWWWDWWWWW    W
W                  W                  W                  W
W DDD          DDD W DDD          DDD W DDD          DDD W
W D D    WW    D D W D D    WW    D D W D D    WW    D D W
WWWWWWWWWWWWWWWWWWWWWWWWWWWWWWWWWWWWWWWWWWWWWWWWWWWWWWWWWWWWWW
W                  W                  W                  W
W       WW         W       WW         W       WW         W
W      WWWWWW      W      WWWWWW      W      WWWWWW      W
W DDD  W    W  DDD W DDD  W    W  DDD W DDD  W    W  DDD W
W D D  W KB W  D D W D D  W B  W  D D W D D  W K  W  D D W
W DDD  W    W  DDD W DDD  W    W  DDD W DDD  W    W  DDD W
W      WWWWWW      W      WWWWWW      W      WWWWWW      W
W       WW         W       WW         W       WW         W
W                  W                  W                  W
WWWWWWWWWWWWWWWWWWWWWWWWWWWWWWWWWWWWWWWWWWWWWWWWWWWWWWWWWWWWWW
W                                                            W
W DDD DDD DDD DDD DDD DDD DDD DDD DDD DDD DDD DDD DDD DDD DD W
W D D D D D D D D D D D D D D D D D D D D D D D D D D D D D D W
W DDD DDD DDD DDD DDD DDD DDD DDD DDD DDD DDD DDD DDD DDD DD W
WWWWWWWWWWWWWWWWWWWWWWWWWWWWWWWWWWWWWWWWWWWWWWWWWWWWWWWWWWWWWW