WWWWWWWWWWWWWWWWWWWWWWWWWWWWWWWWWWWWWWWWWWWWWWWWWWWWWWWWWWWWWW
W  J                                                         W
W WWW DDDD WWW DDD WWW DDDD WWW DDD WWW DDDD WWW DDD WWW DDD W
W   W    D   W   D   W    D   W   D   W    D   W   D   W   D W
W D W DD W D W D W D W DD W D W D W D W DD W D W D W D W DD WW
W D   DD   D   D   D   DD   D   D   D   DD   D   D   D   DD WW
W DDD   DDDD  WWWW  DDDD  DDDDDWWW    DD    DDDD  DDDD   DD  W
W                                                          E W
W DDD WWWWWWWW DDD WWWWWWWW DDD WWWWWWWW DDD WWWWWWWW DDD WW W
W D D W      W D D W      W D D W      W D D W      W D D W  W
W D D W  KB  W D D W  EB  W D D W  KE  W D D W  B   W D D W  W
W D D W      W D D W      W D D W      W D D W      W D D W  W
W DDD WWWWWWWW DDD WWWWWWWW DDD WWWWWWWW DDD WWWWWWWW DDD WW W
W                                                            W
W WWWWWWWWWWWWWWWWWWWWWWWWWWWWWWWWWWWWWWWWWWWWWWWWWWWWWWWW W W   
W WWW DDDD WWW DDD WWW DDDD WWW DDD WWW DDDD WWW DDD WWW DDD W
W                                                            W
W      DDDDDD            DDDDDDD           DDDDDD       DDDD W
W                                                            W
W DDD DDD DDD DDD DDD DDD DDD DDD DDD DDD DDD DDD DDD DDD DD W
W  B        K         D     B                 K          B   W
W DDD DDD DDD DDD DDD DDD DDD DDD DDD DDD DDD DDD DDD DDD DD W
WWWWWWWWWWWWWWWWWWWWWWWWWWWWWWWWWWWWWWWWWWWWWWWWWWWWWWWWWWWWWW