WWWWWWWWWWWWWWWWWWWWWWWWWWWWWWWWWWWWWWWWWWWWWWWWWWWWWWWWWWWWWW
W  J                                                         W
W WWW DDDD WWW DDD WWW DDDD WWW DDD WWW DDDD WWW DDD WWW DDD W
W   W    D   W   D   W    D   W   D   W    D   W   D   W   D W
W D W DD W D W D W D W DD W D W D W D W DD W D W D W D W DD W
W D   DD   D   D   D   DD   D   D   D   DD   D   D   D   DD W
W WWWWWWWWWWWWWWWWWWWWWWWWWWWWWWWWWWWWWWWWWWWWWWWWWWWWWWWW W
W                                                          E W
W DDD WWWWWWWW DDD WWWWWWWW DDD WWWWWWWW DDD WWWWWWWW DDD WW W
W D D W      W D D W      W D D W      W D D W      W D D W  W
W D D W  KB  W D D W  EB  W D D W  KE  W D D W  B   W D D W  W
W D D W      W D D W      W D D W      W D D W      W D D W  W
W DDD WWWWWWWW DDD WWWWWWWW DDD WWWWWWWW DDD WWWWWWWW DDD WW W
W                                                            W
W WWWWWWWWWWWWWWWWWWWWWWWWWWWWWWWWWWWWWWWWWWWWWWWWWWWWWWWW W
W D   DD   D   D   D   DD   D   D   D   DD   D   D   D   DD W
W D W DD W D W D W D W DD W D W D W D W DD W D W D W D W DD W
W   W    D   W   D   W    D   W   D   W    D   W   D   W   D W
W WWW DDDD WWW DDD WWW DDDD WWW DDD WWW DDDD WWW DDD WWW DDD W
W                                                            W
W                                                            W
W                                                            W
W DDD DDD DDD DDD DDD DDD DDD DDD DDD DDD DDD DDD DDD DDD DD W
W D D D D D D D D D D D D D D D D D D D D D D D D D D D D D D W
W DDD DDD DDD DDD DDD DDD DDD DDD DDD DDD DDD DDD DDD DDD DD W